WHEELSONLYPLEASE – Invisible Car
YLTEICZ – Aggressive Traffic
GHOSTTOWN – Reduced Traffic
EVERYONEISRICH – Sweet Ride Car Traffic
EVERYONEISPOOR – P.O.S. Car Traffic
FVTMNBZ – Country Traffic
LLQPFBN – Pink Traffic
IOWDLAC – Black Traffic
ZEIIVG – Green Light Traffic
SPEEDFREAK – All Cars Nitrous Powered
BUBBLECARS – Float float away on impact
FLYINGFISH – Flying Boats
RIPAZHA – Flying Cars
CPKTNWT – Cars Explode
VKYPQCF – Nitrous Taxi’s, L3 Hop
BMTPWHR – Trucker Theme
BMTPWHR – Rural Theme
NINJATOWN – Ninja Theme
NIGHTPROWLER – Eternal Midnight
XJVSNAJ – 00:00 to 12:00
OFVIAC – 21:00
CWJXUOC – Sandstorm
PLEASANTLYWARM – Sunny Weather
TOODAMNHOT – Super Sunny Weather
SCOTTISHSUMMER – Thunderstorm
AUIFRVQS – Rainy Weather
CFVFGMJ – Foggy Weather
ALNSFMZO – Cloudy Weather
BRINGITON – Wanted Level Maxed
STATEOFEMERGENCY – Chaos Mode
BLUESUEDESHOES – Elvis has entered the building
CIKGCGX – Beach Rave
PRIEBJ – Funhouse Theme
BEKKNQV – Kinky Theme
CRAZYTOWN – Carnival Theme
IOJUFZN – Riot Mode
JCNRUAD – Smash N’ Boom
ONLYHOMIESALLOWED – Gang Members Everywhere
FOOOXFT – Armed Peds
BGLUAWML – Peds Attack (Rockets)
AJLOJYQY – Peds Attack Each Other